Sony - PlayStation Portable (UMD Music) Missing

Boxarts   0/34  0.00%
Snaps     0/34  0.00%
Titles    0/34  0.00%
Total    0/102  0.00%

Name                                                                                                    Boxart  Snap  Title
Asian Kung-Fu Generation - Eizo Sakuhinshu - Vol1 (Japan, Europe)                                          ✗      ✗     ✗
Big Snoop Dog's Puff Puff Pass Tour (World)                                                                ✗      ✗     ✗
Blink-182 - Greatest Hits (USA)                                                                            ✗      ✗     ✗
Busta Rhymes - Everything Remains Raw (World)                                                              ✗      ✗     ✗
Daft Punk _ Leiji Matsumoto's - Interstella 5555 - The 5tory Of The 5ecret 5tar 5ystem (World) (En,Fr)     ✗      ✗     ✗
Depeche Mode - 101 (Japan, Europe) (En,Ja,Fr,De,Es,It,Pt)                                                  ✗      ✗     ✗
Depeche Mode - Devotional (Japan, Europe)                                                                  ✗      ✗     ✗
Depeche Mode - One Night In Paris - The Exciter Tour 2001 (Japan, Europe)                                  ✗      ✗     ✗
Goldfrapp - Wonderful Electric - Live In London (World)                                                    ✗      ✗     ✗
Green Day - Bullet in a Bible (Europe)                                                                     ✗      ✗     ✗
Green Day - Bullet in a Bible (Europe) (En,Ja,Fr,De,Es,It,Nl,Pt)                                           ✗      ✗     ✗
Iron Maiden - The Number of the Beast (World) (En,Fr,De,Es,It,Nl,Pt)                                       ✗      ✗     ✗
Marilyn Manson - Guns, God and Government World Tour (World)                                               ✗      ✗     ✗
Metallica - Metallica (World) (Fr,De,Es,It,Nl,Pt)                                                          ✗      ✗     ✗
Nirvana - Nevermind (World) (En,Fr,De,Es,It,Nl,Pt)                                                         ✗      ✗     ✗
Nobody Knows + Mebae (Japan, Europe)                                                                       ✗      ✗     ✗
Okuda Tamio OT Clips Of The Years (Japan, Europe)                                                          ✗      ✗     ✗
Outkast - The Videos (World)                                                                               ✗      ✗     ✗
Pink - Limited Edition (World)                                                                             ✗      ✗     ✗
Pink Floyd - The Making Of The Dark Side of the Moon (World) (Fr,De,Es,It,Nl,Pt)                           ✗      ✗     ✗
Placebo - Soulmates Never Die (World) (En,Fr,De,Es,It) [b]                                                 ✗      ✗     ✗
Puddle of Mudd - Striking That Familiar Chord (World)                                                      ✗      ✗     ✗
Queen - The Making Of A Night at the Opera (World) (En,Fr,De,Es,It,Nl,Pt)                                  ✗      ✗     ✗
Scissor Sisters - We are Scissor Sisters and so are You (World) [b]                                        ✗      ✗     ✗
Shiina Hekiru - Hequil VI (Japan)                                                                          ✗      ✗     ✗
Silbermond - Verschwende Deine Zeit Live (Japan, Europe)                                                   ✗      ✗     ✗
Skoop On Somebody - SOS CLIPS Vol.2 (Japan)                                                                ✗      ✗     ✗
SOUL'd OUT - TOUR 2003 Dream'd Live (Japan)                                                                ✗      ✗     ✗
Tiesto in Concert (World)                                                                                  ✗      ✗     ✗
Tupac - Live at the House of Blues (World)                                                                 ✗      ✗     ✗
U2 Rattle and Hum (Europe) (En,Fr,De,Nl)                                                                   ✗      ✗     ✗
Up in Smoke Tour, The (World)                                                                              ✗      ✗     ✗
YUKI - YUKI VIDEO (Japan)                                                                                  ✗      ✗     ✗
Zakk Wylde's - Black Label Society - Boozed, Broozed _ Broken-Boned (World)                                ✗      ✗     ✗